91111111111111111113
80000000000000000002
80000000000000000002
80000000000000000002
80000000000000000002
80000000000000000002
80000000000000000002
80000000000000000002
80000000000000000002
80000000000000000002
80000000000000000002
80000000000000000002
80000000000000000002
80000000000000000002
80000000000000000002
80000000000000000002
80000000000000000002
80000000000000000002
80000000000000000002
c4444444444444444446

0,0
19,14
